############################
#                          #
#                          #
#                          #
#                          #
#                          #
#                          #
#                          #
#                          #
#                          #
#                          #
#  #######     #######     #
#        #     #           #
#  #######     #     #######
#              #           #
#                          #
#                          #
#                          #
#                          #
#                          #
#                          #
#                          #
#                          #
#                          #
#                          #
#                          #
#                          #
############################
